
  SO        ./code/parsing/img/txt.xpm
            NO     ./code/parsing/img/dgren.xpm
      EA  ./code/parsing/img/nigga.xpm
 WE ./code/parsing/img/purp.xpm

             F  1,90,43
                  C 25,113,149           


         11111111111111111111111111
         10000000000000000000000001
         10100000010000000100000001
         10000000000000000000000001
1111111111000000000W000000000000001
10000001000000000000000000000111111
100000000000000000001000010001               
100000000000000000000000000001
100000000000010000000000000001              
100000000000000010000000000001             
100000000000000000000000000011                
100000000000000000001000000001              
100000000000000000000000000001              
100000000000000001001000000001     
11111111111111111 11 111111111          
