

SO        ./code/parsing/img/txt.xpm
            NO     ./code/parsing/img/dgren.xpm
      EA  ./code/parsing/img/nigga.xpm
WE ./code/parsing/img/purp.xpm


        F  139,90,43      
                  C 25,113,149

         11111111111111111111111111
         10000000001000000000000001
         10100000010000000100000001
         10000000000000000000000001
1111111111000000000S000000000000001
10000001000000000000000000001111111
1000000000000000000010000100001           
100000000000000000000000000001            
100000000000010000000000000001             
100000000000000010000000000001            
100000000000000000000000000011               
100000000000000000001000000001             
100000000000000000000000000001             
100000000000000001001000000001    
11111111111111111 11 111111111     
