
          SO ./code/parsing/img/txt.xpm
                  NO ./code/parsing/img/white_zelija.xpm
      EA           ./code/parsing/img/white_zelija.xpm
WE           ./code/parsing/img/white_zelija.xpm

        F  139,90,43      
              C 25,113,149 

         11111111111111111111111111
         10000000001000000000000001
         10100000010000000100000001
         10000000000000000000000001
1111111111000000000S000000000000001
10000001000000000000000000001111111
100000000000000000000000100001           
100000000000000000000000000001            
100000000000000000000000000001             
100000000000000000000000000001            
100000000000000000000000000011               
100000000000000000000000000001             
100000000000000000000000000001             
100000000000000001001000000001    
11111111111111111 11 111111111     
