
SO ./so_good_so.xpm
NO ./no_good_no.xpm
EA ./ea_good_ea.xpm
WE ./we_good_we.xpm

F 254,222,255
C 225,12,255


         11111111111111111111111111
         10000000001100000000000011
         10110000011100000100000111
         10010000000000000000000011
11111111110000011100001000000011111
11000001001111100011101111101111111
111101111111110111000000100011           
11110111111100S101110101001011         
110000001101010111000000100011             
100000000000000011000000100011            
100000000000000011010100100011               
110000011101010111010111100101             
111101111110101101101101000001
11111111111111111 11 111111111    