
SO ./so_good_so.xpm
NO ./no_good_no.xpm
EA ./ea_good_ea.xpm
WE ./we_good_we.xpm

F 254,222,255
C 225,12,255

         11111111111111111111111111
         10000000001100000000000011
         10110000011100000100000111
         10010000000000000000000011
11111111110000011100000000000011111
110000000001100000111011111011111111
111101111111110111000000100011
111101111111110111010100100011
110000001101010111000000100011
100000000000000011000000100011
100000000000000011010100100011
11000001110101011111011110N111
111101111110101101101101001101
11111111111111111 11 111111111